EA		minimap/west.xpm
NO		xpm/south.xpm
SO		xpm/west.xpm
WE		xpm/east.xpm
F		342,34,234
C 		234,234,234



11111111111111111
11000010000010011
11000010000010011
11000010000010011
11000010000010011
11000000N00100011
11000010000010011
11000010000010011
11000010000010011
11111111111111111